********************
*P-----------------*
*------------------*
*--A---------------*
*------------------>
*------------------*
*------------------*
*--------------O---*
*------------------*
******V*************
