***************V****
*------------------*
*------------------*
*--A--------------->
*------------------*
*------------------*
*------------------*
*------------------*
*------------------*
********************