****V***************
*------------------*
*------------------*
*--A---------------*
*------------------*
*------------------*
*------------------*
<------------------*
*------------------*
********************